# # # # #
# . . . #
# . # . #
# . . . #
# # # # #