# # # # # # # # # # # # # # # # #
# . . . . . . . # . . . . . . . #
# . . . . . . . # . . . . . . . #
# . . . . . . . . . . . . . . . #
# . # # # # # # # . . . . . . . #
# . . . . . . . # . . . . . . . #
# . . . . . . . # # # # # # # . #
# . . . . . . . # . . . . . . . #
# # . # # # # # # . . . . . . . #
# . . . # . . . # . . . . . . . #
# . . . # . . . # # # # . # # # #
# . . . # . . . # . . . . . . . #
# . . . . . . . . . . . . . . . #
# . . . # . . . # . . . . . . . #
# . . . # . . . # . . . . . . . #
# . . . # . . . # . . . . . . . #
# # # # # # # # # # # # # # # # #