# # # # # # # # # # #
# . . . . # . . . . #
# . . . . # . . . . #
# . . # . . . # . . #
# . . . . # . . . . #
# . . . . # . . . . #
# . . # . . . # . . #
# . . . . # . . . . #
# . . . . # . . . . #
# # # # # # # # # # #